"filename", "language", "Rust", "TOML", "comment", "blank", "total"
"/home/eden/CollegeLearningRepo/rust_projects/sort_algo_cmp_rust/Cargo.lock", "TOML", 0, 66, 0, 10, 76
"/home/eden/CollegeLearningRepo/rust_projects/sort_algo_cmp_rust/Cargo.toml", "TOML", 0, 20, 0, 7, 27
"/home/eden/CollegeLearningRepo/rust_projects/sort_algo_cmp_rust/src/main.rs", "Rust", 85, 0, 0, 5, 90
"/home/eden/CollegeLearningRepo/rust_projects/sort_algo_cmp_rust/src/sort.rs", "Rust", 117, 0, 0, 6, 123
"/home/eden/CollegeLearningRepo/rust_projects/sort_algo_cmp_rust/src/sort/bubble_sort.rs", "Rust", 18, 0, 0, 1, 19
"/home/eden/CollegeLearningRepo/rust_projects/sort_algo_cmp_rust/src/sort/heap_sort.rs", "Rust", 39, 0, 0, 2, 41
"/home/eden/CollegeLearningRepo/rust_projects/sort_algo_cmp_rust/src/sort/insertion_sort.rs", "Rust", 28, 0, 0, 2, 30
"/home/eden/CollegeLearningRepo/rust_projects/sort_algo_cmp_rust/src/sort/merge_sort.rs", "Rust", 39, 0, 0, 5, 44
"/home/eden/CollegeLearningRepo/rust_projects/sort_algo_cmp_rust/src/sort/quick_sort.rs", "Rust", 71, 0, 0, 4, 75
"/home/eden/CollegeLearningRepo/rust_projects/sort_algo_cmp_rust/src/sort/radix_sort.rs", "Rust", 72, 0, 0, 8, 80
"/home/eden/CollegeLearningRepo/rust_projects/sort_algo_cmp_rust/src/sort/selection_sort.rs", "Rust", 15, 0, 0, 1, 16
"/home/eden/CollegeLearningRepo/rust_projects/sort_algo_cmp_rust/src/sort/shell_sort.rs", "Rust", 39, 0, 0, 3, 42
"Total", "-", 523, 86, 0, 54, 663